NO ./textures/north_wall.xpm
WE ./textures/west_wall.xpm
EA ./textures/east_wall.xpm
SO ./textures/south_wall.xpm


C 55j5552,255,255
F 00,153,,,,,,,,,,,,,,,,,0000005


        1111111111111111111111111
         1000000000000000000000001
         1100000000000000000000001
        1000000000000000000000001
111111111000000000000000000000001
10000000000000000000000000001111
1000000000000S10000000000001
1111111111111111111111111111
1000000000000000000000000001111
10000000000000000000000000001
10000000000000000000000000011111111111111111
10000000000000000000000000001
10000000000000000000000000001
10000000000000000000000000001
10000000000000000000000000001
10000000000000000000000000001
10000000000000000000000000001
10000000000000000000000000001
10000000000000000000000000001
10000000000000000000000000001
10000000000000000000000000001
10000000000000000000000000001
10000000000000000000000000001
10000000000000000001010000001
11000001110101011111011110101
11110111 1110111 101111010001
11111111 1111111 111111111111
